,Video,Shape_type,Name,Color name,Color BGR,Thickness,topLeftX,topLeftY,Bottom_right_X,Bottom_right_Y,width,height,Tags,Ear_tag_size
0,HybCD1-B1-D5-LocoPost-TC-Agouti,Rectangle,Gate-Non-Fighting,Coral,"(80, 127, 255)",5,1059,1032,1185,1154,126,122,"{'Center tag': (1122, 1093), 'Top left tag': (1059, 1032), 'Bottom right tag': (1185, 1154), 'Top right tag': (1185, 1032), 'Bottom left tag': (1059, 1154), 'Top tag': (1122, 1032), 'Right tag': (1185, 1093), 'Left tag': (1059, 1093), 'Bottom tag': (1122, 1154)}",10
1,HybCD1-B1-D5-LocoPost-TC-Agouti,Rectangle,Hiding-corner-3,Yellow,"(0, 255, 255)",5,1732,1028,1923,1163,191,135,"{'Center tag': (1827, 1095), 'Top left tag': (1732, 1028), 'Bottom right tag': (1923, 1163), 'Top right tag': (1923, 1028), 'Bottom left tag': (1732, 1163), 'Top tag': (1827, 1028), 'Right tag': (1923, 1095), 'Left tag': (1732, 1095), 'Bottom tag': (1827, 1163)}",10
2,HybCD1-B1-D5-LocoPost-TC-Agouti,Rectangle,Resource zone,Green,"(0, 128, 0)",5,810,192,1244,465,434,273,"{'Center tag': (1027, 328), 'Top left tag': (810, 192), 'Bottom right tag': (1244, 465), 'Top right tag': (1244, 192), 'Bottom left tag': (810, 465), 'Top tag': (1027, 192), 'Right tag': (1244, 328), 'Left tag': (810, 328), 'Bottom tag': (1027, 465)}",10
3,HybCD1-B1-D5-LocoPost-TC-Agouti,Rectangle,Middle wall,Chocolate,"(30, 105, 210)",5,1021,473,1046,1155,25,682,"{'Center tag': (1033, 814), 'Top left tag': (1021, 473), 'Bottom right tag': (1046, 1155), 'Top right tag': (1046, 473), 'Bottom left tag': (1021, 1155), 'Top tag': (1033, 473), 'Right tag': (1046, 814), 'Left tag': (1021, 814), 'Bottom tag': (1033, 1155)}",10
4,HybCD1-B1-D5-LocoPost-TC-Agouti,Rectangle,Gate-Fighting,Coral,"(80, 127, 255)",5,889,1030,1015,1152,126,122,"{'Center tag': (952, 1091), 'Top left tag': (889, 1030), 'Bottom right tag': (1015, 1152), 'Top right tag': (1015, 1030), 'Bottom left tag': (889, 1152), 'Top tag': (952, 1030), 'Right tag': (1015, 1091), 'Left tag': (889, 1091), 'Bottom tag': (952, 1152)}",10
5,HybCD1-B1-D5-LocoPost-TC-Agouti,Rectangle,Hiding-corner-2,Yellow,"(0, 255, 255)",5,1755,207,1923,337,168,130,"{'Center tag': (1839, 272), 'Top left tag': (1755, 207), 'Bottom right tag': (1923, 337), 'Top right tag': (1923, 207), 'Bottom left tag': (1755, 337), 'Top tag': (1839, 207), 'Right tag': (1923, 272), 'Left tag': (1755, 272), 'Bottom tag': (1839, 337)}",10
6,HybCD1-B1-D5-LocoPost-TC-Agouti,Rectangle,Hiding-corner-4,Yellow,"(0, 255, 255)",5,116,1019,299,1160,183,141,"{'Center tag': (207, 1089), 'Top left tag': (116, 1019), 'Bottom right tag': (299, 1160), 'Top right tag': (299, 1019), 'Bottom left tag': (116, 1160), 'Top tag': (207, 1019), 'Right tag': (299, 1089), 'Left tag': (116, 1089), 'Bottom tag': (207, 1160)}",10
7,HybCD1-B1-D5-LocoPost-TC-Agouti,Rectangle,Nest,White,"(255, 255, 255)",5,948,194,1115,313,167,119,"{'Center tag': (1031, 253), 'Top left tag': (948, 194), 'Bottom right tag': (1115, 313), 'Top right tag': (1115, 194), 'Bottom left tag': (948, 313), 'Top tag': (1031, 194), 'Right tag': (1115, 253), 'Left tag': (948, 253), 'Bottom tag': (1031, 313)}",10
8,HybCD1-B1-D5-LocoPost-TC-Agouti,Rectangle,Hiding-corner-1,Yellow,"(0, 255, 255)",5,128,165,286,293,158,128,"{'Center tag': (207, 229), 'Top left tag': (128, 165), 'Bottom right tag': (286, 293), 'Top right tag': (286, 165), 'Bottom left tag': (128, 293), 'Top tag': (207, 165), 'Right tag': (286, 229), 'Left tag': (128, 229), 'Bottom tag': (207, 293)}",10
9,HybCD1-B1-D5-LocoPost-TC-Black,Rectangle,Hiding-corner-3,Yellow,"(0, 255, 255)",5,1755,942,1925,1076,170,134,"{'Center tag': (1840, 1009), 'Top left tag': (1755, 942), 'Bottom right tag': (1925, 1076), 'Top right tag': (1925, 942), 'Bottom left tag': (1755, 1076), 'Top tag': (1840, 942), 'Right tag': (1925, 1009), 'Left tag': (1755, 1009), 'Bottom tag': (1840, 1076)}",10
10,HybCD1-B1-D5-LocoPost-TC-Black,Rectangle,Hiding-corner-2,Yellow,"(0, 255, 255)",5,1765,125,1935,250,170,125,"{'Center tag': (1850, 187), 'Top left tag': (1765, 125), 'Bottom right tag': (1935, 250), 'Top right tag': (1935, 125), 'Bottom left tag': (1765, 250), 'Top tag': (1850, 125), 'Right tag': (1935, 187), 'Left tag': (1765, 187), 'Bottom tag': (1850, 250)}",10
11,HybCD1-B1-D5-LocoPost-TC-Black,Rectangle,Nest,White,"(255, 255, 255)",5,941,138,1120,266,179,128,"{'Center tag': (1030, 202), 'Top left tag': (941, 138), 'Bottom right tag': (1120, 266), 'Top right tag': (1120, 138), 'Bottom left tag': (941, 266), 'Top tag': (1030, 138), 'Right tag': (1120, 202), 'Left tag': (941, 202), 'Bottom tag': (1030, 266)}",10
12,HybCD1-B1-D5-LocoPost-TC-Black,Rectangle,Middle wall,Chocolate,"(30, 105, 210)",5,1013,442,1055,1120,42,678,"{'Center tag': (1034, 781), 'Top left tag': (1013, 442), 'Bottom right tag': (1055, 1120), 'Top right tag': (1055, 442), 'Bottom left tag': (1013, 1120), 'Top tag': (1034, 442), 'Right tag': (1055, 781), 'Left tag': (1013, 781), 'Bottom tag': (1034, 1120)}",10
13,HybCD1-B1-D5-LocoPost-TC-Black,Rectangle,Hiding-corner-1,Yellow,"(0, 255, 255)",5,114,118,278,234,164,116,"{'Center tag': (196, 176), 'Top left tag': (114, 118), 'Bottom right tag': (278, 234), 'Top right tag': (278, 118), 'Bottom left tag': (114, 234), 'Top tag': (196, 118), 'Right tag': (278, 176), 'Left tag': (114, 176), 'Bottom tag': (196, 234)}",10
14,HybCD1-B1-D5-LocoPost-TC-Black,Rectangle,Resource zone,Green,"(0, 128, 0)",5,849,139,1238,435,389,296,"{'Center tag': (1043, 287), 'Top left tag': (849, 139), 'Bottom right tag': (1238, 435), 'Top right tag': (1238, 139), 'Bottom left tag': (849, 435), 'Top tag': (1043, 139), 'Right tag': (1238, 287), 'Left tag': (849, 287), 'Bottom tag': (1043, 435)}",10
15,HybCD1-B1-D5-LocoPost-TC-Black,Rectangle,Gate-Non-Fighting,Coral,"(80, 127, 255)",5,1059,978,1180,1096,121,118,"{'Center tag': (1119, 1037), 'Top left tag': (1059, 978), 'Bottom right tag': (1180, 1096), 'Top right tag': (1180, 978), 'Bottom left tag': (1059, 1096), 'Top tag': (1119, 978), 'Right tag': (1180, 1037), 'Left tag': (1059, 1037), 'Bottom tag': (1119, 1096)}",10
16,HybCD1-B1-D5-LocoPost-TC-Black,Rectangle,Hiding-corner-4,Yellow,"(0, 255, 255)",5,147,958,319,1092,172,134,"{'Center tag': (233, 1025), 'Top left tag': (147, 958), 'Bottom right tag': (319, 1092), 'Top right tag': (319, 958), 'Bottom left tag': (147, 1092), 'Top tag': (233, 958), 'Right tag': (319, 1025), 'Left tag': (147, 1025), 'Bottom tag': (233, 1092)}",10
17,HybCD1-B1-D5-LocoPost-TC-Black,Rectangle,Gate-Fighting,Coral,"(80, 127, 255)",5,902,978,1023,1096,121,118,"{'Center tag': (962, 1037), 'Top left tag': (902, 978), 'Bottom right tag': (1023, 1096), 'Top right tag': (1023, 978), 'Bottom left tag': (902, 1096), 'Top tag': (962, 978), 'Right tag': (1023, 1037), 'Left tag': (902, 1037), 'Bottom tag': (962, 1096)}",10
18,HybCD1-B1-D5-LocoPre-TC-Agouti,Rectangle,Gate-Fighting,Coral,"(80, 127, 255)",5,875,1023,1003,1151,128,128,"{'Center tag': (939, 1087), 'Top left tag': (875, 1023), 'Bottom right tag': (1003, 1151), 'Top right tag': (1003, 1023), 'Bottom left tag': (875, 1151), 'Top tag': (939, 1023), 'Right tag': (1003, 1087), 'Left tag': (875, 1087), 'Bottom tag': (939, 1151)}",10
19,HybCD1-B1-D5-LocoPre-TC-Agouti,Rectangle,Gate-Non-Fighting,Coral,"(80, 127, 255)",5,1039,1021,1167,1149,128,128,"{'Center tag': (1103, 1085), 'Top left tag': (1039, 1021), 'Bottom right tag': (1167, 1149), 'Top right tag': (1167, 1021), 'Bottom left tag': (1039, 1149), 'Top tag': (1103, 1021), 'Right tag': (1167, 1085), 'Left tag': (1039, 1085), 'Bottom tag': (1103, 1149)}",10
20,HybCD1-B1-D5-LocoPre-TC-Agouti,Rectangle,Middle wall,Chocolate,"(30, 105, 210)",5,1006,445,1038,1170,32,725,"{'Center tag': (1022, 807), 'Top left tag': (1006, 445), 'Bottom right tag': (1038, 1170), 'Top right tag': (1038, 445), 'Bottom left tag': (1006, 1170), 'Top tag': (1022, 445), 'Right tag': (1038, 807), 'Left tag': (1006, 807), 'Bottom tag': (1022, 1170)}",10
21,HybCD1-B1-D5-LocoPre-TC-Agouti,Rectangle,Hiding-corner-3,Yellow,"(0, 255, 255)",5,1746,998,1929,1130,183,132,"{'Center tag': (1837, 1064), 'Top left tag': (1746, 998), 'Bottom right tag': (1929, 1130), 'Top right tag': (1929, 998), 'Bottom left tag': (1746, 1130), 'Top tag': (1837, 998), 'Right tag': (1929, 1064), 'Left tag': (1746, 1064), 'Bottom tag': (1837, 1130)}",10
22,HybCD1-B1-D5-LocoPre-TC-Agouti,Rectangle,Hiding-corner-2,Yellow,"(0, 255, 255)",5,1751,167,1934,299,183,132,"{'Center tag': (1842, 233), 'Top left tag': (1751, 167), 'Bottom right tag': (1934, 299), 'Top right tag': (1934, 167), 'Bottom left tag': (1751, 299), 'Top tag': (1842, 167), 'Right tag': (1934, 233), 'Left tag': (1751, 233), 'Bottom tag': (1842, 299)}",10
23,HybCD1-B1-D5-LocoPre-TC-Agouti,Rectangle,Hiding-corner-4,Yellow,"(0, 255, 255)",5,112,1010,295,1142,183,132,"{'Center tag': (203, 1076), 'Top left tag': (112, 1010), 'Bottom right tag': (295, 1142), 'Top right tag': (295, 1010), 'Bottom left tag': (112, 1142), 'Top tag': (203, 1010), 'Right tag': (295, 1076), 'Left tag': (112, 1076), 'Bottom tag': (203, 1142)}",10
24,HybCD1-B1-D5-LocoPre-TC-Agouti,Rectangle,Hiding-corner-1,Yellow,"(0, 255, 255)",5,114,163,297,295,183,132,"{'Center tag': (205, 229), 'Top left tag': (114, 163), 'Bottom right tag': (297, 295), 'Top right tag': (297, 163), 'Bottom left tag': (114, 295), 'Top tag': (205, 163), 'Right tag': (297, 229), 'Left tag': (114, 229), 'Bottom tag': (205, 295)}",10
25,HybCD1-B1-D5-LocoPre-TC-Agouti,Rectangle,Resource zone,Green,"(0, 128, 0)",5,847,186,1238,483,391,297,"{'Center tag': (1042, 334), 'Top left tag': (847, 186), 'Bottom right tag': (1238, 483), 'Top right tag': (1238, 186), 'Bottom left tag': (847, 483), 'Top tag': (1042, 186), 'Right tag': (1238, 334), 'Left tag': (847, 334), 'Bottom tag': (1042, 483)}",10
26,HybCD1-B1-D5-LocoPre-TC-Agouti,Rectangle,Nest,White,"(255, 255, 255)",5,943,168,1113,306,170,138,"{'Center tag': (1028, 237), 'Top left tag': (943, 168), 'Bottom right tag': (1113, 306), 'Top right tag': (1113, 168), 'Bottom left tag': (943, 306), 'Top tag': (1028, 168), 'Right tag': (1113, 237), 'Left tag': (943, 237), 'Bottom tag': (1028, 306)}",10
27,HybCD1-B1-D5-LocoPre-TC-Black,Rectangle,Gate-Non-Fighting,Coral,"(80, 127, 255)",5,1053,1021,1189,1142,136,121,"{'Center tag': (1121, 1081), 'Top left tag': (1053, 1021), 'Bottom right tag': (1189, 1142), 'Top right tag': (1189, 1021), 'Bottom left tag': (1053, 1142), 'Top tag': (1121, 1021), 'Right tag': (1189, 1081), 'Left tag': (1053, 1081), 'Bottom tag': (1121, 1142)}",10
28,HybCD1-B1-D5-LocoPre-TC-Black,Rectangle,Hiding-corner-3,Yellow,"(0, 255, 255)",5,1754,1014,1916,1139,162,125,"{'Center tag': (1835, 1076), 'Top left tag': (1754, 1014), 'Bottom right tag': (1916, 1139), 'Top right tag': (1916, 1014), 'Bottom left tag': (1754, 1139), 'Top tag': (1835, 1014), 'Right tag': (1916, 1076), 'Left tag': (1754, 1076), 'Bottom tag': (1835, 1139)}",10
29,HybCD1-B1-D5-LocoPre-TC-Black,Rectangle,Hiding-corner-1,Yellow,"(0, 255, 255)",5,118,184,280,309,162,125,"{'Center tag': (199, 246), 'Top left tag': (118, 184), 'Bottom right tag': (280, 309), 'Top right tag': (280, 184), 'Bottom left tag': (118, 309), 'Top tag': (199, 184), 'Right tag': (280, 246), 'Left tag': (118, 246), 'Bottom tag': (199, 309)}",10
30,HybCD1-B1-D5-LocoPre-TC-Black,Rectangle,Gate-Fighting,Coral,"(80, 127, 255)",5,871,1021,1007,1142,136,121,"{'Center tag': (939, 1081), 'Top left tag': (871, 1021), 'Bottom right tag': (1007, 1142), 'Top right tag': (1007, 1021), 'Bottom left tag': (871, 1142), 'Top tag': (939, 1021), 'Right tag': (1007, 1081), 'Left tag': (871, 1081), 'Bottom tag': (939, 1142)}",10
31,HybCD1-B1-D5-LocoPre-TC-Black,Rectangle,Hiding-corner-4,Yellow,"(0, 255, 255)",5,115,1020,277,1145,162,125,"{'Center tag': (196, 1082), 'Top left tag': (115, 1020), 'Bottom right tag': (277, 1145), 'Top right tag': (277, 1020), 'Bottom left tag': (115, 1145), 'Top tag': (196, 1020), 'Right tag': (277, 1082), 'Left tag': (115, 1082), 'Bottom tag': (196, 1145)}",10
32,HybCD1-B1-D5-LocoPre-TC-Black,Rectangle,Resource zone,Green,"(0, 128, 0)",5,798,184,1219,457,421,273,"{'Center tag': (1008, 320), 'Top left tag': (798, 184), 'Bottom right tag': (1219, 457), 'Top right tag': (1219, 184), 'Bottom left tag': (798, 457), 'Top tag': (1008, 184), 'Right tag': (1219, 320), 'Left tag': (798, 320), 'Bottom tag': (1008, 457)}",10
33,HybCD1-B1-D5-LocoPre-TC-Black,Rectangle,Nest,White,"(255, 255, 255)",5,960,165,1129,318,169,153,"{'Center tag': (1044, 241), 'Top left tag': (960, 165), 'Bottom right tag': (1129, 318), 'Top right tag': (1129, 165), 'Bottom left tag': (960, 318), 'Top tag': (1044, 165), 'Right tag': (1129, 241), 'Left tag': (960, 241), 'Bottom tag': (1044, 318)}",10
34,HybCD1-B1-D5-LocoPre-TC-Black,Rectangle,Hiding-corner-2,Yellow,"(0, 255, 255)",5,1742,167,1904,292,162,125,"{'Center tag': (1823, 229), 'Top left tag': (1742, 167), 'Bottom right tag': (1904, 292), 'Top right tag': (1904, 167), 'Bottom left tag': (1742, 292), 'Top tag': (1823, 167), 'Right tag': (1904, 229), 'Left tag': (1742, 229), 'Bottom tag': (1823, 292)}",10
35,HybCD1-B1-D5-LocoPre-TC-Black,Rectangle,Middle wall,Chocolate,"(30, 105, 210)",5,1002,435,1054,1147,52,712,"{'Center tag': (1028, 791), 'Top left tag': (1002, 435), 'Bottom right tag': (1054, 1147), 'Top right tag': (1054, 435), 'Bottom left tag': (1002, 1147), 'Top tag': (1028, 435), 'Right tag': (1054, 791), 'Left tag': (1002, 791), 'Bottom tag': (1028, 1147)}",10
36,HybCD1-B2-D5-LocoPost-TC-Agouti,Rectangle,Gate-Non-Fighting,Coral,"(80, 127, 255)",5,1077,1024,1221,1158,144,134,"{'Center tag': (1149, 1091), 'Top left tag': (1077, 1024), 'Bottom right tag': (1221, 1158), 'Top right tag': (1221, 1024), 'Bottom left tag': (1077, 1158), 'Top tag': (1149, 1024), 'Right tag': (1221, 1091), 'Left tag': (1077, 1091), 'Bottom tag': (1149, 1158)}",10
37,HybCD1-B2-D5-LocoPost-TC-Agouti,Rectangle,Hiding-corner-4,Yellow,"(0, 255, 255)",5,119,1028,298,1159,179,131,"{'Center tag': (208, 1093), 'Top left tag': (119, 1028), 'Bottom right tag': (298, 1159), 'Top right tag': (298, 1028), 'Bottom left tag': (119, 1159), 'Top tag': (208, 1028), 'Right tag': (298, 1093), 'Left tag': (119, 1093), 'Bottom tag': (208, 1159)}",10
38,HybCD1-B2-D5-LocoPost-TC-Agouti,Rectangle,Hiding-corner-1,Yellow,"(0, 255, 255)",5,109,179,288,310,179,131,"{'Center tag': (198, 244), 'Top left tag': (109, 179), 'Bottom right tag': (288, 310), 'Top right tag': (288, 179), 'Bottom left tag': (109, 310), 'Top tag': (198, 179), 'Right tag': (288, 244), 'Left tag': (109, 244), 'Bottom tag': (198, 310)}",10
39,HybCD1-B2-D5-LocoPost-TC-Agouti,Rectangle,Gate-Fighting,Coral,"(80, 127, 255)",5,874,1022,1018,1156,144,134,"{'Center tag': (946, 1089), 'Top left tag': (874, 1022), 'Bottom right tag': (1018, 1156), 'Top right tag': (1018, 1022), 'Bottom left tag': (874, 1156), 'Top tag': (946, 1022), 'Right tag': (1018, 1089), 'Left tag': (874, 1089), 'Bottom tag': (946, 1156)}",10
40,HybCD1-B2-D5-LocoPost-TC-Agouti,Rectangle,Nest,White,"(255, 255, 255)",5,918,179,1089,316,171,137,"{'Center tag': (1003, 247), 'Top left tag': (918, 179), 'Bottom right tag': (1089, 316), 'Top right tag': (1089, 179), 'Bottom left tag': (918, 316), 'Top tag': (1003, 179), 'Right tag': (1089, 247), 'Left tag': (918, 247), 'Bottom tag': (1003, 316)}",10
41,HybCD1-B2-D5-LocoPost-TC-Agouti,Rectangle,Hiding-corner-3,Yellow,"(0, 255, 255)",5,1755,1001,1934,1132,179,131,"{'Center tag': (1844, 1066), 'Top left tag': (1755, 1001), 'Bottom right tag': (1934, 1132), 'Top right tag': (1934, 1001), 'Bottom left tag': (1755, 1132), 'Top tag': (1844, 1001), 'Right tag': (1934, 1066), 'Left tag': (1755, 1066), 'Bottom tag': (1844, 1132)}",10
42,HybCD1-B2-D5-LocoPost-TC-Agouti,Rectangle,Hiding-corner-2,Yellow,"(0, 255, 255)",5,1741,189,1920,320,179,131,"{'Center tag': (1830, 254), 'Top left tag': (1741, 189), 'Bottom right tag': (1920, 320), 'Top right tag': (1920, 189), 'Bottom left tag': (1741, 320), 'Top tag': (1830, 189), 'Right tag': (1920, 254), 'Left tag': (1741, 254), 'Bottom tag': (1830, 320)}",10
43,HybCD1-B2-D5-LocoPost-TC-Agouti,Rectangle,Middle wall,Chocolate,"(30, 105, 210)",5,1022,462,1075,1170,53,708,"{'Center tag': (1048, 816), 'Top left tag': (1022, 462), 'Bottom right tag': (1075, 1170), 'Top right tag': (1075, 462), 'Bottom left tag': (1022, 1170), 'Top tag': (1048, 462), 'Right tag': (1075, 816), 'Left tag': (1022, 816), 'Bottom tag': (1048, 1170)}",10
44,HybCD1-B2-D5-LocoPost-TC-Agouti,Rectangle,Resource zone,Green,"(0, 128, 0)",5,814,186,1242,496,428,310,"{'Center tag': (1028, 341), 'Top left tag': (814, 186), 'Bottom right tag': (1242, 496), 'Top right tag': (1242, 186), 'Bottom left tag': (814, 496), 'Top tag': (1028, 186), 'Right tag': (1242, 341), 'Left tag': (814, 341), 'Bottom tag': (1028, 496)}",10
45,HybCD1-B2-D5-LocoPost-TC-Black,Rectangle,Middle wall,Chocolate,"(30, 105, 210)",5,999,408,1050,1120,51,712,"{'Center tag': (1024, 764), 'Top left tag': (999, 408), 'Bottom right tag': (1050, 1120), 'Top right tag': (1050, 408), 'Bottom left tag': (999, 1120), 'Top tag': (1024, 408), 'Right tag': (1050, 764), 'Left tag': (999, 764), 'Bottom tag': (1024, 1120)}",10
46,HybCD1-B2-D5-LocoPost-TC-Black,Rectangle,Hiding-corner-3,Yellow,"(0, 255, 255)",5,1745,990,1929,1131,184,141,"{'Center tag': (1837, 1060), 'Top left tag': (1745, 990), 'Bottom right tag': (1929, 1131), 'Top right tag': (1929, 990), 'Bottom left tag': (1745, 1131), 'Top tag': (1837, 990), 'Right tag': (1929, 1060), 'Left tag': (1745, 1060), 'Bottom tag': (1837, 1131)}",10
47,HybCD1-B2-D5-LocoPost-TC-Black,Rectangle,Hiding-corner-1,Yellow,"(0, 255, 255)",5,102,117,286,258,184,141,"{'Center tag': (194, 187), 'Top left tag': (102, 117), 'Bottom right tag': (286, 258), 'Top right tag': (286, 117), 'Bottom left tag': (102, 258), 'Top tag': (194, 117), 'Right tag': (286, 187), 'Left tag': (102, 187), 'Bottom tag': (194, 258)}",10
48,HybCD1-B2-D5-LocoPost-TC-Black,Rectangle,Nest,White,"(255, 255, 255)",5,946,138,1132,274,186,136,"{'Center tag': (1039, 206), 'Top left tag': (946, 138), 'Bottom right tag': (1132, 274), 'Top right tag': (1132, 138), 'Bottom left tag': (946, 274), 'Top tag': (1039, 138), 'Right tag': (1132, 206), 'Left tag': (946, 206), 'Bottom tag': (1039, 274)}",10
49,HybCD1-B2-D5-LocoPost-TC-Black,Rectangle,Resource zone,Green,"(0, 128, 0)",5,795,139,1252,435,457,296,"{'Center tag': (1023, 287), 'Top left tag': (795, 139), 'Bottom right tag': (1252, 435), 'Top right tag': (1252, 139), 'Bottom left tag': (795, 435), 'Top tag': (1023, 139), 'Right tag': (1252, 287), 'Left tag': (795, 287), 'Bottom tag': (1023, 435)}",10
50,HybCD1-B2-D5-LocoPost-TC-Black,Rectangle,Gate-Fighting,Coral,"(80, 127, 255)",5,866,996,995,1121,129,125,"{'Center tag': (930, 1058), 'Top left tag': (866, 996), 'Bottom right tag': (995, 1121), 'Top right tag': (995, 996), 'Bottom left tag': (866, 1121), 'Top tag': (930, 996), 'Right tag': (995, 1058), 'Left tag': (866, 1058), 'Bottom tag': (930, 1121)}",10
51,HybCD1-B2-D5-LocoPost-TC-Black,Rectangle,Hiding-corner-2,Yellow,"(0, 255, 255)",5,1745,155,1929,296,184,141,"{'Center tag': (1837, 225), 'Top left tag': (1745, 155), 'Bottom right tag': (1929, 296), 'Top right tag': (1929, 155), 'Bottom left tag': (1745, 296), 'Top tag': (1837, 155), 'Right tag': (1929, 225), 'Left tag': (1745, 225), 'Bottom tag': (1837, 296)}",10
52,HybCD1-B2-D5-LocoPost-TC-Black,Rectangle,Hiding-corner-4,Yellow,"(0, 255, 255)",5,109,996,293,1137,184,141,"{'Center tag': (201, 1066), 'Top left tag': (109, 996), 'Bottom right tag': (293, 1137), 'Top right tag': (293, 996), 'Bottom left tag': (109, 1137), 'Top tag': (201, 996), 'Right tag': (293, 1066), 'Left tag': (109, 1066), 'Bottom tag': (201, 1137)}",10
53,HybCD1-B2-D5-LocoPost-TC-Black,Rectangle,Gate-Non-Fighting,Coral,"(80, 127, 255)",5,1057,998,1186,1123,129,125,"{'Center tag': (1121, 1060), 'Top left tag': (1057, 998), 'Bottom right tag': (1186, 1123), 'Top right tag': (1186, 998), 'Bottom left tag': (1057, 1123), 'Top tag': (1121, 998), 'Right tag': (1186, 1060), 'Left tag': (1057, 1060), 'Bottom tag': (1121, 1123)}",10
54,HybCD1-B2-D5-LocoPre-TC-Agouti,Rectangle,Gate-Non-Fighting,Coral,"(80, 127, 255)",5,982,1029,1116,1138,134,109,"{'Center tag': (1049, 1083), 'Top left tag': (982, 1029), 'Bottom right tag': (1116, 1138), 'Top right tag': (1116, 1029), 'Bottom left tag': (982, 1138), 'Top tag': (1049, 1029), 'Right tag': (1116, 1083), 'Left tag': (982, 1083), 'Bottom tag': (1049, 1138)}",10
55,HybCD1-B2-D5-LocoPre-TC-Agouti,Rectangle,Gate-Fighting,Coral,"(80, 127, 255)",5,801,1021,935,1130,134,109,"{'Center tag': (868, 1075), 'Top left tag': (801, 1021), 'Bottom right tag': (935, 1130), 'Top right tag': (935, 1021), 'Bottom left tag': (801, 1130), 'Top tag': (868, 1021), 'Right tag': (935, 1075), 'Left tag': (801, 1075), 'Bottom tag': (868, 1130)}",10
56,HybCD1-B2-D5-LocoPre-TC-Agouti,Rectangle,Resource zone,Green,"(0, 128, 0)",5,790,136,1219,459,429,323,"{'Center tag': (1004, 297), 'Top left tag': (790, 136), 'Bottom right tag': (1219, 459), 'Top right tag': (1219, 136), 'Bottom left tag': (790, 459), 'Top tag': (1004, 136), 'Right tag': (1219, 297), 'Left tag': (790, 297), 'Bottom tag': (1004, 459)}",10
57,HybCD1-B2-D5-LocoPre-TC-Agouti,Rectangle,Hiding-corner-4,Yellow,"(0, 255, 255)",5,99,993,286,1128,187,135,"{'Center tag': (192, 1060), 'Top left tag': (99, 993), 'Bottom right tag': (286, 1128), 'Top right tag': (286, 993), 'Bottom left tag': (99, 1128), 'Top tag': (192, 993), 'Right tag': (286, 1060), 'Left tag': (99, 1060), 'Bottom tag': (192, 1128)}",10
58,HybCD1-B2-D5-LocoPre-TC-Agouti,Rectangle,Hiding-corner-2,Yellow,"(0, 255, 255)",5,1746,120,1933,255,187,135,"{'Center tag': (1839, 187), 'Top left tag': (1746, 120), 'Bottom right tag': (1933, 255), 'Top right tag': (1933, 120), 'Bottom left tag': (1746, 255), 'Top tag': (1839, 120), 'Right tag': (1933, 187), 'Left tag': (1746, 187), 'Bottom tag': (1839, 255)}",10
59,HybCD1-B2-D5-LocoPre-TC-Agouti,Rectangle,Middle wall,Chocolate,"(30, 105, 210)",5,938,441,983,1136,45,695,"{'Center tag': (960, 788), 'Top left tag': (938, 441), 'Bottom right tag': (983, 1136), 'Top right tag': (983, 441), 'Bottom left tag': (938, 1136), 'Top tag': (960, 441), 'Right tag': (983, 788), 'Left tag': (938, 788), 'Bottom tag': (960, 1136)}",10
60,HybCD1-B2-D5-LocoPre-TC-Agouti,Rectangle,Hiding-corner-3,Yellow,"(0, 255, 255)",5,1753,970,1940,1105,187,135,"{'Center tag': (1846, 1037), 'Top left tag': (1753, 970), 'Bottom right tag': (1940, 1105), 'Top right tag': (1940, 970), 'Bottom left tag': (1753, 1105), 'Top tag': (1846, 970), 'Right tag': (1940, 1037), 'Left tag': (1753, 1037), 'Bottom tag': (1846, 1105)}",10
61,HybCD1-B2-D5-LocoPre-TC-Agouti,Rectangle,Hiding-corner-1,Yellow,"(0, 255, 255)",5,96,144,283,279,187,135,"{'Center tag': (189, 211), 'Top left tag': (96, 144), 'Bottom right tag': (283, 279), 'Top right tag': (283, 144), 'Bottom left tag': (96, 279), 'Top tag': (189, 144), 'Right tag': (283, 211), 'Left tag': (96, 211), 'Bottom tag': (189, 279)}",10
62,HybCD1-B2-D5-LocoPre-TC-Agouti,Rectangle,White,White,"(255, 255, 255)",5,920,123,1104,268,184,145,"{'Center tag': (1012, 195), 'Top left tag': (920, 123), 'Bottom right tag': (1104, 268), 'Top right tag': (1104, 123), 'Bottom left tag': (920, 268), 'Top tag': (1012, 123), 'Right tag': (1104, 195), 'Left tag': (920, 195), 'Bottom tag': (1012, 268)}",10
63,HybCD1-B2-D5-LocoPre-TC-Black,Rectangle,Middle wall,Chocolate,"(30, 105, 210)",5,972,393,1013,1120,41,727,"{'Center tag': (992, 756), 'Top left tag': (972, 393), 'Bottom right tag': (1013, 1120), 'Top right tag': (1013, 393), 'Bottom left tag': (972, 1120), 'Top tag': (992, 393), 'Right tag': (1013, 756), 'Left tag': (972, 756), 'Bottom tag': (992, 1120)}",10
64,HybCD1-B2-D5-LocoPre-TC-Black,Rectangle,Hiding-corner-4,Yellow,"(0, 255, 255)",5,88,1003,291,1138,203,135,"{'Center tag': (189, 1070), 'Top left tag': (88, 1003), 'Bottom right tag': (291, 1138), 'Top right tag': (291, 1003), 'Bottom left tag': (88, 1138), 'Top tag': (189, 1003), 'Right tag': (291, 1070), 'Left tag': (88, 1070), 'Bottom tag': (189, 1138)}",10
65,HybCD1-B2-D5-LocoPre-TC-Black,Rectangle,Gate-Non-Fighting,Coral,"(80, 127, 255)",5,1017,1022,1142,1139,125,117,"{'Center tag': (1079, 1080), 'Top left tag': (1017, 1022), 'Bottom right tag': (1142, 1139), 'Top right tag': (1142, 1022), 'Bottom left tag': (1017, 1139), 'Top tag': (1079, 1022), 'Right tag': (1142, 1080), 'Left tag': (1017, 1080), 'Bottom tag': (1079, 1139)}",10
66,HybCD1-B2-D5-LocoPre-TC-Black,Rectangle,Hiding-corner-1,Yellow,"(0, 255, 255)",5,96,119,299,254,203,135,"{'Center tag': (197, 186), 'Top left tag': (96, 119), 'Bottom right tag': (299, 254), 'Top right tag': (299, 119), 'Bottom left tag': (96, 254), 'Top tag': (197, 119), 'Right tag': (299, 186), 'Left tag': (96, 186), 'Bottom tag': (197, 254)}",10
67,HybCD1-B2-D5-LocoPre-TC-Black,Rectangle,Resource zone,Green,"(0, 128, 0)",5,828,143,1247,427,419,284,"{'Center tag': (1037, 285), 'Top left tag': (828, 143), 'Bottom right tag': (1247, 427), 'Top right tag': (1247, 143), 'Bottom left tag': (828, 427), 'Top tag': (1037, 143), 'Right tag': (1247, 285), 'Left tag': (828, 285), 'Bottom tag': (1037, 427)}",10
68,HybCD1-B2-D5-LocoPre-TC-Black,Rectangle,Hiding-corner-3,Yellow,"(0, 255, 255)",5,1734,999,1937,1134,203,135,"{'Center tag': (1835, 1066), 'Top left tag': (1734, 999), 'Bottom right tag': (1937, 1134), 'Top right tag': (1937, 999), 'Bottom left tag': (1734, 1134), 'Top tag': (1835, 999), 'Right tag': (1937, 1066), 'Left tag': (1734, 1066), 'Bottom tag': (1835, 1134)}",10
69,HybCD1-B2-D5-LocoPre-TC-Black,Rectangle,Nest,White,"(255, 255, 255)",5,953,143,1127,273,174,130,"{'Center tag': (1040, 208), 'Top left tag': (953, 143), 'Bottom right tag': (1127, 273), 'Top right tag': (1127, 143), 'Bottom left tag': (953, 273), 'Top tag': (1040, 143), 'Right tag': (1127, 208), 'Left tag': (953, 208), 'Bottom tag': (1040, 273)}",10
70,HybCD1-B2-D5-LocoPre-TC-Black,Rectangle,Gate-Fighting,Coral,"(80, 127, 255)",5,846,1025,971,1142,125,117,"{'Center tag': (908, 1083), 'Top left tag': (846, 1025), 'Bottom right tag': (971, 1142), 'Top right tag': (971, 1025), 'Bottom left tag': (846, 1142), 'Top tag': (908, 1025), 'Right tag': (971, 1083), 'Left tag': (846, 1083), 'Bottom tag': (908, 1142)}",10
71,HybCD1-B2-D5-LocoPre-TC-Black,Rectangle,Hiding-corner-2,Yellow,"(0, 255, 255)",5,1720,145,1923,280,203,135,"{'Center tag': (1821, 212), 'Top left tag': (1720, 145), 'Bottom right tag': (1923, 280), 'Top right tag': (1923, 145), 'Bottom left tag': (1720, 280), 'Top tag': (1821, 145), 'Right tag': (1923, 212), 'Left tag': (1720, 212), 'Bottom tag': (1821, 280)}",10
72,HybCD1-B3-D5-LocoPost-TC-LS,Rectangle,Hiding-corner-4,Yellow,"(0, 255, 255)",5,104,1038,298,1177,194,139,"{'Center tag': (201, 1107), 'Top left tag': (104, 1038), 'Bottom right tag': (298, 1177), 'Top right tag': (298, 1038), 'Bottom left tag': (104, 1177), 'Top tag': (201, 1038), 'Right tag': (298, 1107), 'Left tag': (104, 1107), 'Bottom tag': (201, 1177)}",10
73,HybCD1-B3-D5-LocoPost-TC-LS,Rectangle,Middle wall,Chocolate,"(30, 105, 210)",5,1013,435,1050,1143,37,708,"{'Center tag': (1031, 789), 'Top left tag': (1013, 435), 'Bottom right tag': (1050, 1143), 'Top right tag': (1050, 435), 'Bottom left tag': (1013, 1143), 'Top tag': (1031, 435), 'Right tag': (1050, 789), 'Left tag': (1013, 789), 'Bottom tag': (1031, 1143)}",10
74,HybCD1-B3-D5-LocoPost-TC-LS,Rectangle,Resource zone,Green,"(0, 128, 0)",5,812,152,1266,445,454,293,"{'Center tag': (1039, 298), 'Top left tag': (812, 152), 'Bottom right tag': (1266, 445), 'Top right tag': (1266, 152), 'Bottom left tag': (812, 445), 'Top tag': (1039, 152), 'Right tag': (1266, 298), 'Left tag': (812, 298), 'Bottom tag': (1039, 445)}",10
75,HybCD1-B3-D5-LocoPost-TC-LS,Rectangle,Hiding-corner-1,Yellow,"(0, 255, 255)",5,98,121,292,260,194,139,"{'Center tag': (195, 190), 'Top left tag': (98, 121), 'Bottom right tag': (292, 260), 'Top right tag': (292, 121), 'Bottom left tag': (98, 260), 'Top tag': (195, 121), 'Right tag': (292, 190), 'Left tag': (98, 190), 'Bottom tag': (195, 260)}",10
76,HybCD1-B3-D5-LocoPost-TC-LS,Rectangle,Hiding-corner-3,Yellow,"(0, 255, 255)",5,1733,1014,1927,1153,194,139,"{'Center tag': (1830, 1083), 'Top left tag': (1733, 1014), 'Bottom right tag': (1927, 1153), 'Top right tag': (1927, 1014), 'Bottom left tag': (1733, 1153), 'Top tag': (1830, 1014), 'Right tag': (1927, 1083), 'Left tag': (1733, 1083), 'Bottom tag': (1830, 1153)}",10
77,HybCD1-B3-D5-LocoPost-TC-LS,Rectangle,Hiding-corner-2,Yellow,"(0, 255, 255)",5,1740,147,1934,286,194,139,"{'Center tag': (1837, 216), 'Top left tag': (1740, 147), 'Bottom right tag': (1934, 286), 'Top right tag': (1934, 147), 'Bottom left tag': (1740, 286), 'Top tag': (1837, 147), 'Right tag': (1934, 216), 'Left tag': (1740, 216), 'Bottom tag': (1837, 286)}",10
78,HybCD1-B3-D5-LocoPost-TC-LS,Rectangle,Nest,White,"(255, 255, 255)",5,960,141,1134,282,174,141,"{'Center tag': (1047, 211), 'Top left tag': (960, 141), 'Bottom right tag': (1134, 282), 'Top right tag': (1134, 141), 'Bottom left tag': (960, 282), 'Top tag': (1047, 141), 'Right tag': (1134, 211), 'Left tag': (960, 211), 'Bottom tag': (1047, 282)}",10
79,HybCD1-B3-D5-LocoPost-TC-LS,Rectangle,Gate-Non-Fighting,Coral,"(80, 127, 255)",5,1052,1051,1190,1172,138,121,"{'Center tag': (1121, 1111), 'Top left tag': (1052, 1051), 'Bottom right tag': (1190, 1172), 'Top right tag': (1190, 1051), 'Bottom left tag': (1052, 1172), 'Top tag': (1121, 1051), 'Right tag': (1190, 1111), 'Left tag': (1052, 1111), 'Bottom tag': (1121, 1172)}",10
80,HybCD1-B3-D5-LocoPost-TC-LS,Rectangle,Gate-Fighting,Coral,"(80, 127, 255)",5,871,1052,1009,1173,138,121,"{'Center tag': (940, 1112), 'Top left tag': (871, 1052), 'Bottom right tag': (1009, 1173), 'Top right tag': (1009, 1052), 'Bottom left tag': (871, 1173), 'Top tag': (940, 1052), 'Right tag': (1009, 1112), 'Left tag': (871, 1112), 'Bottom tag': (940, 1173)}",10
81,HybCD1-B3-D5-LocoPost-TC-US,Rectangle,Resource zone,White,"(255, 255, 255)",5,918,139,1108,284,190,145,"{'Center tag': (1013, 211), 'Top left tag': (918, 139), 'Bottom right tag': (1108, 284), 'Top right tag': (1108, 139), 'Bottom left tag': (918, 284), 'Top tag': (1013, 139), 'Right tag': (1108, 211), 'Left tag': (918, 211), 'Bottom tag': (1013, 284)}",10
82,HybCD1-B3-D5-LocoPost-TC-US,Rectangle,Hiding-corner-2,Yellow,"(0, 255, 255)",5,1752,138,1926,262,174,124,"{'Center tag': (1839, 200), 'Top left tag': (1752, 138), 'Bottom right tag': (1926, 262), 'Top right tag': (1926, 138), 'Bottom left tag': (1752, 262), 'Top tag': (1839, 138), 'Right tag': (1926, 200), 'Left tag': (1752, 200), 'Bottom tag': (1839, 262)}",10
83,HybCD1-B3-D5-LocoPost-TC-US,Rectangle,Gate-Non-Fighting,Coral,"(80, 127, 255)",5,1084,1056,1208,1175,124,119,"{'Center tag': (1146, 1115), 'Top left tag': (1084, 1056), 'Bottom right tag': (1208, 1175), 'Top right tag': (1208, 1056), 'Bottom left tag': (1084, 1175), 'Top tag': (1146, 1056), 'Right tag': (1208, 1115), 'Left tag': (1084, 1115), 'Bottom tag': (1146, 1175)}",10
84,HybCD1-B3-D5-LocoPost-TC-US,Rectangle,Gate-Fighting,Coral,"(80, 127, 255)",5,896,1058,1020,1177,124,119,"{'Center tag': (958, 1117), 'Top left tag': (896, 1058), 'Bottom right tag': (1020, 1177), 'Top right tag': (1020, 1058), 'Bottom left tag': (896, 1177), 'Top tag': (958, 1058), 'Right tag': (1020, 1117), 'Left tag': (896, 1117), 'Bottom tag': (958, 1177)}",10
85,HybCD1-B3-D5-LocoPost-TC-US,Rectangle,Hiding-corner-1,Yellow,"(0, 255, 255)",5,102,138,276,262,174,124,"{'Center tag': (189, 200), 'Top left tag': (102, 138), 'Bottom right tag': (276, 262), 'Top right tag': (276, 138), 'Bottom left tag': (102, 262), 'Top tag': (189, 138), 'Right tag': (276, 200), 'Left tag': (102, 200), 'Bottom tag': (189, 262)}",10
86,HybCD1-B3-D5-LocoPost-TC-US,Rectangle,Resource zone,Green,"(0, 128, 0)",5,823,151,1278,466,455,315,"{'Center tag': (1050, 308), 'Top left tag': (823, 151), 'Bottom right tag': (1278, 466), 'Top right tag': (1278, 151), 'Bottom left tag': (823, 466), 'Top tag': (1050, 151), 'Right tag': (1278, 308), 'Left tag': (823, 308), 'Bottom tag': (1050, 466)}",10
87,HybCD1-B3-D5-LocoPost-TC-US,Rectangle,Hiding-corner-4,Yellow,"(0, 255, 255)",5,112,1043,286,1167,174,124,"{'Center tag': (199, 1105), 'Top left tag': (112, 1043), 'Bottom right tag': (286, 1167), 'Top right tag': (286, 1043), 'Bottom left tag': (112, 1167), 'Top tag': (199, 1043), 'Right tag': (286, 1105), 'Left tag': (112, 1105), 'Bottom tag': (199, 1167)}",10
88,HybCD1-B3-D5-LocoPost-TC-US,Rectangle,Hiding-corner-3,Yellow,"(0, 255, 255)",5,1743,1002,1917,1126,174,124,"{'Center tag': (1830, 1064), 'Top left tag': (1743, 1002), 'Bottom right tag': (1917, 1126), 'Top right tag': (1917, 1002), 'Bottom left tag': (1743, 1126), 'Top tag': (1830, 1002), 'Right tag': (1917, 1064), 'Left tag': (1743, 1064), 'Bottom tag': (1830, 1126)}",10
89,HybCD1-B3-D5-LocoPost-TC-US,Rectangle,Middle wall,Chocolate,"(30, 105, 210)",5,1025,466,1077,1163,52,697,"{'Center tag': (1051, 814), 'Top left tag': (1025, 466), 'Bottom right tag': (1077, 1163), 'Top right tag': (1077, 466), 'Bottom left tag': (1025, 1163), 'Top tag': (1051, 466), 'Right tag': (1077, 814), 'Left tag': (1025, 814), 'Bottom tag': (1051, 1163)}",10
90,HybCD1-B3-D5-LocoPre-TC-LS,Rectangle,Hiding-corner-1,Yellow,"(0, 255, 255)",5,125,118,278,256,153,138,"{'Center tag': (201, 187), 'Top left tag': (125, 118), 'Bottom right tag': (278, 256), 'Top right tag': (278, 118), 'Bottom left tag': (125, 256), 'Top tag': (201, 118), 'Right tag': (278, 187), 'Left tag': (125, 187), 'Bottom tag': (201, 256)}",10
91,HybCD1-B3-D5-LocoPre-TC-LS,Rectangle,Hiding-corner-4,Yellow,"(0, 255, 255)",5,103,1020,256,1158,153,138,"{'Center tag': (179, 1089), 'Top left tag': (103, 1020), 'Bottom right tag': (256, 1158), 'Top right tag': (256, 1020), 'Bottom left tag': (103, 1158), 'Top tag': (179, 1020), 'Right tag': (256, 1089), 'Left tag': (103, 1089), 'Bottom tag': (179, 1158)}",10
92,HybCD1-B3-D5-LocoPre-TC-LS,Rectangle,Nest,White,"(255, 255, 255)",5,913,141,1101,282,188,141,"{'Center tag': (1007, 211), 'Top left tag': (913, 141), 'Bottom right tag': (1101, 282), 'Top right tag': (1101, 141), 'Bottom left tag': (913, 282), 'Top tag': (1007, 141), 'Right tag': (1101, 211), 'Left tag': (913, 211), 'Bottom tag': (1007, 282)}",10
93,HybCD1-B3-D5-LocoPre-TC-LS,Rectangle,Hiding-corner-2,Yellow,"(0, 255, 255)",5,1776,148,1929,286,153,138,"{'Center tag': (1852, 217), 'Top left tag': (1776, 148), 'Bottom right tag': (1929, 286), 'Top right tag': (1929, 148), 'Bottom left tag': (1776, 286), 'Top tag': (1852, 148), 'Right tag': (1929, 217), 'Left tag': (1776, 217), 'Bottom tag': (1852, 286)}",10
94,HybCD1-B3-D5-LocoPre-TC-LS,Rectangle,Gate-Non-Fighting,Coral,"(80, 127, 255)",5,1054,1045,1181,1173,127,128,"{'Center tag': (1117, 1109), 'Top left tag': (1054, 1045), 'Bottom right tag': (1181, 1173), 'Top right tag': (1181, 1045), 'Bottom left tag': (1054, 1173), 'Top tag': (1117, 1045), 'Right tag': (1181, 1109), 'Left tag': (1054, 1109), 'Bottom tag': (1117, 1173)}",10
95,HybCD1-B3-D5-LocoPre-TC-LS,Rectangle,Resource zone,Green,"(0, 128, 0)",5,804,144,1232,448,428,304,"{'Center tag': (1018, 296), 'Top left tag': (804, 144), 'Bottom right tag': (1232, 448), 'Top right tag': (1232, 144), 'Bottom left tag': (804, 448), 'Top tag': (1018, 144), 'Right tag': (1232, 296), 'Left tag': (804, 296), 'Bottom tag': (1018, 448)}",10
96,HybCD1-B3-D5-LocoPre-TC-LS,Rectangle,Middle wall,Chocolate,"(30, 105, 210)",5,1002,435,1054,1132,52,697,"{'Center tag': (1028, 783), 'Top left tag': (1002, 435), 'Bottom right tag': (1054, 1132), 'Top right tag': (1054, 435), 'Bottom left tag': (1002, 1132), 'Top tag': (1028, 435), 'Right tag': (1054, 783), 'Left tag': (1002, 783), 'Bottom tag': (1028, 1132)}",10
97,HybCD1-B3-D5-LocoPre-TC-LS,Rectangle,Hiding-corner-3,Yellow,"(0, 255, 255)",5,1774,1024,1927,1162,153,138,"{'Center tag': (1850, 1093), 'Top left tag': (1774, 1024), 'Bottom right tag': (1927, 1162), 'Top right tag': (1927, 1024), 'Bottom left tag': (1774, 1162), 'Top tag': (1850, 1024), 'Right tag': (1927, 1093), 'Left tag': (1774, 1093), 'Bottom tag': (1850, 1162)}",10
98,HybCD1-B3-D5-LocoPre-TC-LS,Rectangle,Gate-Fighting,Coral,"(80, 127, 255)",5,889,1043,1016,1171,127,128,"{'Center tag': (952, 1107), 'Top left tag': (889, 1043), 'Bottom right tag': (1016, 1171), 'Top right tag': (1016, 1043), 'Bottom left tag': (889, 1171), 'Top tag': (952, 1043), 'Right tag': (1016, 1107), 'Left tag': (889, 1107), 'Bottom tag': (952, 1171)}",10
99,HybCD1-B3-D5-LocoPre-TC-US,Rectangle,Hiding-corner-1,Yellow,"(0, 255, 255)",5,120,122,282,258,162,136,"{'Center tag': (201, 190), 'Top left tag': (120, 122), 'Bottom right tag': (282, 258), 'Top right tag': (282, 122), 'Bottom left tag': (120, 258), 'Top tag': (201, 122), 'Right tag': (282, 190), 'Left tag': (120, 190), 'Bottom tag': (201, 258)}",10
100,HybCD1-B3-D5-LocoPre-TC-US,Rectangle,Nest,White,"(255, 255, 255)",5,932,120,1118,253,186,133,"{'Center tag': (1025, 186), 'Top left tag': (932, 120), 'Bottom right tag': (1118, 253), 'Top right tag': (1118, 120), 'Bottom left tag': (932, 253), 'Top tag': (1025, 120), 'Right tag': (1118, 186), 'Left tag': (932, 186), 'Bottom tag': (1025, 253)}",10
101,HybCD1-B3-D5-LocoPre-TC-US,Rectangle,Resource zone,Green,"(0, 128, 0)",5,824,125,1266,459,442,334,"{'Center tag': (1045, 292), 'Top left tag': (824, 125), 'Bottom right tag': (1266, 459), 'Top right tag': (1266, 125), 'Bottom left tag': (824, 459), 'Top tag': (1045, 125), 'Right tag': (1266, 292), 'Left tag': (824, 292), 'Bottom tag': (1045, 459)}",10
102,HybCD1-B3-D5-LocoPre-TC-US,Rectangle,Hiding-corner-3,Yellow,"(0, 255, 255)",5,1763,971,1925,1107,162,136,"{'Center tag': (1844, 1039), 'Top left tag': (1763, 971), 'Bottom right tag': (1925, 1107), 'Top right tag': (1925, 971), 'Bottom left tag': (1763, 1107), 'Top tag': (1844, 971), 'Right tag': (1925, 1039), 'Left tag': (1763, 1039), 'Bottom tag': (1844, 1107)}",10
103,HybCD1-B3-D5-LocoPre-TC-US,Rectangle,Hiding-corner-2,Yellow,"(0, 255, 255)",5,1771,128,1933,264,162,136,"{'Center tag': (1852, 196), 'Top left tag': (1771, 128), 'Bottom right tag': (1933, 264), 'Top right tag': (1933, 128), 'Bottom left tag': (1771, 264), 'Top tag': (1852, 128), 'Right tag': (1933, 196), 'Left tag': (1771, 196), 'Bottom tag': (1852, 264)}",10
104,HybCD1-B3-D5-LocoPre-TC-US,Rectangle,Gate-Non-Fighting,Coral,"(80, 127, 255)",5,1081,1026,1218,1141,137,115,"{'Center tag': (1149, 1083), 'Top left tag': (1081, 1026), 'Bottom right tag': (1218, 1141), 'Top right tag': (1218, 1026), 'Bottom left tag': (1081, 1141), 'Top tag': (1149, 1026), 'Right tag': (1218, 1083), 'Left tag': (1081, 1083), 'Bottom tag': (1149, 1141)}",10
105,HybCD1-B3-D5-LocoPre-TC-US,Rectangle,Gate-Fighting,Coral,"(80, 127, 255)",5,903,1027,1040,1142,137,115,"{'Center tag': (971, 1084), 'Top left tag': (903, 1027), 'Bottom right tag': (1040, 1142), 'Top right tag': (1040, 1027), 'Bottom left tag': (903, 1142), 'Top tag': (971, 1027), 'Right tag': (1040, 1084), 'Left tag': (903, 1084), 'Bottom tag': (971, 1142)}",10
106,HybCD1-B3-D5-LocoPre-TC-US,Rectangle,Middle wall,Chocolate,"(30, 105, 210)",5,1050,449,1108,1140,58,691,"{'Center tag': (1079, 794), 'Top left tag': (1050, 449), 'Bottom right tag': (1108, 1140), 'Top right tag': (1108, 449), 'Bottom left tag': (1050, 1140), 'Top tag': (1079, 449), 'Right tag': (1108, 794), 'Left tag': (1050, 794), 'Bottom tag': (1079, 1140)}",10
107,HybCD1-B3-D5-LocoPre-TC-US,Rectangle,Hiding-corner-4,Yellow,"(0, 255, 255)",5,122,979,284,1115,162,136,"{'Center tag': (203, 1047), 'Top left tag': (122, 979), 'Bottom right tag': (284, 1115), 'Top right tag': (284, 979), 'Bottom left tag': (122, 1115), 'Top tag': (203, 979), 'Right tag': (284, 1047), 'Left tag': (122, 1047), 'Bottom tag': (203, 1115)}",10
108,HybCD1-B4-D5-LocoPost-TC-LS,Rectangle,Resource zone,Green,"(0, 128, 0)",5,750,134,1183,449,433,315,"{'Center tag': (966, 291), 'Top left tag': (750, 134), 'Bottom right tag': (1183, 449), 'Top right tag': (1183, 134), 'Bottom left tag': (750, 449), 'Top tag': (966, 134), 'Right tag': (1183, 291), 'Left tag': (750, 291), 'Bottom tag': (966, 449)}",10
109,HybCD1-B4-D5-LocoPost-TC-LS,Rectangle,Gate-Non-Fighting,Coral,"(80, 127, 255)",5,954,1043,1086,1151,132,108,"{'Center tag': (1020, 1097), 'Top left tag': (954, 1043), 'Bottom right tag': (1086, 1151), 'Top right tag': (1086, 1043), 'Bottom left tag': (954, 1151), 'Top tag': (1020, 1043), 'Right tag': (1086, 1097), 'Left tag': (954, 1097), 'Bottom tag': (1020, 1151)}",10
110,HybCD1-B4-D5-LocoPost-TC-LS,Rectangle,Gate-Fighting,Coral,"(80, 127, 255)",5,786,1047,918,1155,132,108,"{'Center tag': (852, 1101), 'Top left tag': (786, 1047), 'Bottom right tag': (918, 1155), 'Top right tag': (918, 1047), 'Bottom left tag': (786, 1155), 'Top tag': (852, 1047), 'Right tag': (918, 1101), 'Left tag': (786, 1101), 'Bottom tag': (852, 1155)}",10
111,HybCD1-B4-D5-LocoPost-TC-LS,Rectangle,Hiding-corner-4,Yellow,"(0, 255, 255)",5,37,966,186,1104,149,138,"{'Center tag': (111, 1035), 'Top left tag': (37, 966), 'Bottom right tag': (186, 1104), 'Top right tag': (186, 966), 'Bottom left tag': (37, 1104), 'Top tag': (111, 966), 'Right tag': (186, 1035), 'Left tag': (37, 1035), 'Bottom tag': (111, 1104)}",10
112,HybCD1-B4-D5-LocoPost-TC-LS,Rectangle,Hiding-corner-2,Yellow,"(0, 255, 255)",5,1715,135,1864,273,149,138,"{'Center tag': (1789, 204), 'Top left tag': (1715, 135), 'Bottom right tag': (1864, 273), 'Top right tag': (1864, 135), 'Bottom left tag': (1715, 273), 'Top tag': (1789, 135), 'Right tag': (1864, 204), 'Left tag': (1715, 204), 'Bottom tag': (1789, 273)}",10
113,HybCD1-B4-D5-LocoPost-TC-LS,Rectangle,Hiding-corner-3,Yellow,"(0, 255, 255)",5,1708,1032,1857,1170,149,138,"{'Center tag': (1782, 1101), 'Top left tag': (1708, 1032), 'Bottom right tag': (1857, 1170), 'Top right tag': (1857, 1032), 'Bottom left tag': (1708, 1170), 'Top tag': (1782, 1032), 'Right tag': (1857, 1101), 'Left tag': (1708, 1101), 'Bottom tag': (1782, 1170)}",10
114,HybCD1-B4-D5-LocoPost-TC-LS,Rectangle,Hiding-corner-1,Yellow,"(0, 255, 255)",5,58,115,207,253,149,138,"{'Center tag': (132, 184), 'Top left tag': (58, 115), 'Bottom right tag': (207, 253), 'Top right tag': (207, 115), 'Bottom left tag': (58, 253), 'Top tag': (132, 115), 'Right tag': (207, 184), 'Left tag': (58, 184), 'Bottom tag': (132, 253)}",10
115,HybCD1-B4-D5-LocoPost-TC-LS,Rectangle,Nest,White,"(255, 255, 255)",5,863,143,1073,265,210,122,"{'Center tag': (968, 204), 'Top left tag': (863, 143), 'Bottom right tag': (1073, 265), 'Top right tag': (1073, 143), 'Bottom left tag': (863, 265), 'Top tag': (968, 143), 'Right tag': (1073, 204), 'Left tag': (863, 204), 'Bottom tag': (968, 265)}",10
116,HybCD1-B4-D5-LocoPost-TC-LS,Rectangle,Middle wall,Chocolate,"(30, 105, 210)",5,926,428,962,1138,36,710,"{'Center tag': (944, 783), 'Top left tag': (926, 428), 'Bottom right tag': (962, 1138), 'Top right tag': (962, 428), 'Bottom left tag': (926, 1138), 'Top tag': (944, 428), 'Right tag': (962, 783), 'Left tag': (926, 783), 'Bottom tag': (944, 1138)}",10
117,HybCD1-B4-D5-LocoPost-TC-US,Rectangle,Hiding-corner-2,Yellow,"(0, 255, 255)",5,1884,141,2025,283,141,142,"{'Center tag': (1954, 212), 'Top left tag': (1884, 141), 'Bottom right tag': (2025, 283), 'Top right tag': (2025, 141), 'Bottom left tag': (1884, 283), 'Top tag': (1954, 141), 'Right tag': (2025, 212), 'Left tag': (1884, 212), 'Bottom tag': (1954, 283)}",10
118,HybCD1-B4-D5-LocoPost-TC-US,Rectangle,Hiding-corner-3,Yellow,"(0, 255, 255)",5,1880,997,2021,1139,141,142,"{'Center tag': (1950, 1068), 'Top left tag': (1880, 997), 'Bottom right tag': (2021, 1139), 'Top right tag': (2021, 997), 'Bottom left tag': (1880, 1139), 'Top tag': (1950, 997), 'Right tag': (2021, 1068), 'Left tag': (1880, 1068), 'Bottom tag': (1950, 1139)}",10
119,HybCD1-B4-D5-LocoPost-TC-US,Rectangle,Resource zone,Green,"(0, 128, 0)",5,903,165,1356,478,453,313,"{'Center tag': (1129, 321), 'Top left tag': (903, 165), 'Bottom right tag': (1356, 478), 'Top right tag': (1356, 165), 'Bottom left tag': (903, 478), 'Top tag': (1129, 165), 'Right tag': (1356, 321), 'Left tag': (903, 321), 'Bottom tag': (1129, 478)}",10
120,HybCD1-B4-D5-LocoPost-TC-US,Rectangle,Hiding-corner-1,Yellow,"(0, 255, 255)",5,231,156,372,298,141,142,"{'Center tag': (301, 227), 'Top left tag': (231, 156), 'Bottom right tag': (372, 298), 'Top right tag': (372, 156), 'Bottom left tag': (231, 298), 'Top tag': (301, 156), 'Right tag': (372, 227), 'Left tag': (231, 227), 'Bottom tag': (301, 298)}",10
121,HybCD1-B4-D5-LocoPost-TC-US,Rectangle,Hiding-corner-4,Yellow,"(0, 255, 255)",5,237,983,378,1125,141,142,"{'Center tag': (307, 1054), 'Top left tag': (237, 983), 'Bottom right tag': (378, 1125), 'Top right tag': (378, 983), 'Bottom left tag': (237, 1125), 'Top tag': (307, 983), 'Right tag': (378, 1054), 'Left tag': (237, 1054), 'Bottom tag': (307, 1125)}",10
122,HybCD1-B4-D5-LocoPost-TC-US,Rectangle,Nest,White,"(255, 255, 255)",5,1028,165,1233,290,205,125,"{'Center tag': (1130, 227), 'Top left tag': (1028, 165), 'Bottom right tag': (1233, 290), 'Top right tag': (1233, 165), 'Bottom left tag': (1028, 290), 'Top tag': (1130, 165), 'Right tag': (1233, 227), 'Left tag': (1028, 227), 'Bottom tag': (1130, 290)}",10
123,HybCD1-B4-D5-LocoPost-TC-US,Rectangle,Gate-Fighting_copy_1,Coral,"(80, 127, 255)",5,1122,1038,1257,1153,135,115,"{'Center tag': (1189, 1095), 'Top left tag': (1122, 1038), 'Bottom right tag': (1257, 1153), 'Top right tag': (1257, 1038), 'Bottom left tag': (1122, 1153), 'Top tag': (1189, 1038), 'Right tag': (1257, 1095), 'Left tag': (1122, 1095), 'Bottom tag': (1189, 1153)}",10
124,HybCD1-B4-D5-LocoPost-TC-US,Rectangle,Gate-Fighting,Coral,"(80, 127, 255)",5,939,1033,1074,1148,135,115,"{'Center tag': (1006, 1090), 'Top left tag': (939, 1033), 'Bottom right tag': (1074, 1148), 'Top right tag': (1074, 1033), 'Bottom left tag': (939, 1148), 'Top tag': (1006, 1033), 'Right tag': (1074, 1090), 'Left tag': (939, 1090), 'Bottom tag': (1006, 1148)}",10
125,HybCD1-B4-D5-LocoPost-TC-US,Rectangle,Middle wall,Chocolate,"(30, 105, 210)",5,1079,449,1121,1171,42,722,"{'Center tag': (1100, 810), 'Top left tag': (1079, 449), 'Bottom right tag': (1121, 1171), 'Top right tag': (1121, 449), 'Bottom left tag': (1079, 1171), 'Top tag': (1100, 449), 'Right tag': (1121, 810), 'Left tag': (1079, 810), 'Bottom tag': (1100, 1171)}",10
126,HybCD1-B4-D5-LocoPre-TC-LS,Rectangle,Gate-Fighting,Coral,"(80, 127, 255)",5,885,1047,1011,1167,126,120,"{'Center tag': (948, 1107), 'Top left tag': (885, 1047), 'Bottom right tag': (1011, 1167), 'Top right tag': (1011, 1047), 'Bottom left tag': (885, 1167), 'Top tag': (948, 1047), 'Right tag': (1011, 1107), 'Left tag': (885, 1107), 'Bottom tag': (948, 1167)}",10
127,HybCD1-B4-D5-LocoPre-TC-LS,Rectangle,Gate-Non-Fighting,Coral,"(80, 127, 255)",5,1038,1051,1164,1171,126,120,"{'Center tag': (1101, 1111), 'Top left tag': (1038, 1051), 'Bottom right tag': (1164, 1171), 'Top right tag': (1164, 1051), 'Bottom left tag': (1038, 1171), 'Top tag': (1101, 1051), 'Right tag': (1164, 1111), 'Left tag': (1038, 1111), 'Bottom tag': (1101, 1171)}",10
128,HybCD1-B4-D5-LocoPre-TC-LS,Rectangle,Hiding-corner-1,Yellow,"(0, 255, 255)",5,129,118,278,249,149,131,"{'Center tag': (203, 183), 'Top left tag': (129, 118), 'Bottom right tag': (278, 249), 'Top right tag': (278, 118), 'Bottom left tag': (129, 249), 'Top tag': (203, 118), 'Right tag': (278, 183), 'Left tag': (129, 183), 'Bottom tag': (203, 249)}",10
129,HybCD1-B4-D5-LocoPre-TC-LS,Rectangle,Hiding-corner-4,Yellow,"(0, 255, 255)",5,116,1001,265,1132,149,131,"{'Center tag': (190, 1066), 'Top left tag': (116, 1001), 'Bottom right tag': (265, 1132), 'Top right tag': (265, 1001), 'Bottom left tag': (116, 1132), 'Top tag': (190, 1001), 'Right tag': (265, 1066), 'Left tag': (116, 1066), 'Bottom tag': (190, 1132)}",10
130,HybCD1-B4-D5-LocoPre-TC-LS,Rectangle,Hiding-corner-3,Yellow,"(0, 255, 255)",5,1774,1038,1923,1169,149,131,"{'Center tag': (1848, 1103), 'Top left tag': (1774, 1038), 'Bottom right tag': (1923, 1169), 'Top right tag': (1923, 1038), 'Bottom left tag': (1774, 1169), 'Top tag': (1848, 1038), 'Right tag': (1923, 1103), 'Left tag': (1774, 1103), 'Bottom tag': (1848, 1169)}",10
131,HybCD1-B4-D5-LocoPre-TC-LS,Rectangle,Hiding-corner-2,Yellow,"(0, 255, 255)",5,1792,172,1941,303,149,131,"{'Center tag': (1866, 237), 'Top left tag': (1792, 172), 'Bottom right tag': (1941, 303), 'Top right tag': (1941, 172), 'Bottom left tag': (1792, 303), 'Top tag': (1866, 172), 'Right tag': (1941, 237), 'Left tag': (1792, 237), 'Bottom tag': (1866, 303)}",10
132,HybCD1-B4-D5-LocoPre-TC-LS,Rectangle,Nest,White,"(255, 255, 255)",5,967,162,1146,292,179,130,"{'Center tag': (1056, 227), 'Top left tag': (967, 162), 'Bottom right tag': (1146, 292), 'Top right tag': (1146, 162), 'Bottom left tag': (967, 292), 'Top tag': (1056, 162), 'Right tag': (1146, 227), 'Left tag': (967, 227), 'Bottom tag': (1056, 292)}",10
133,HybCD1-B4-D5-LocoPre-TC-LS,Rectangle,Middle wall,Chocolate,"(30, 105, 210)",5,1011,459,1058,1157,47,698,"{'Center tag': (1034, 808), 'Top left tag': (1011, 459), 'Bottom right tag': (1058, 1157), 'Top right tag': (1058, 459), 'Bottom left tag': (1011, 1157), 'Top tag': (1034, 459), 'Right tag': (1058, 808), 'Left tag': (1011, 808), 'Bottom tag': (1034, 1157)}",10
134,HybCD1-B4-D5-LocoPre-TC-LS,Rectangle,Resource zone,Green,"(0, 128, 0)",5,838,163,1261,462,423,299,"{'Center tag': (1049, 312), 'Top left tag': (838, 163), 'Bottom right tag': (1261, 462), 'Top right tag': (1261, 163), 'Bottom left tag': (838, 462), 'Top tag': (1049, 163), 'Right tag': (1261, 312), 'Left tag': (838, 312), 'Bottom tag': (1049, 462)}",10
135,HybCD1-B4-D5-LocoPre-TC-US,Rectangle,Gate-Fighting,Coral,"(80, 127, 255)",5,862,1068,988,1179,126,111,"{'Center tag': (925, 1123), 'Top left tag': (862, 1068), 'Bottom right tag': (988, 1179), 'Top right tag': (988, 1068), 'Bottom left tag': (862, 1179), 'Top tag': (925, 1068), 'Right tag': (988, 1123), 'Left tag': (862, 1123), 'Bottom tag': (925, 1179)}",10
136,HybCD1-B4-D5-LocoPre-TC-US,Rectangle,Nest,White,"(255, 255, 255)",5,913,166,1094,309,181,143,"{'Center tag': (1003, 237), 'Top left tag': (913, 166), 'Bottom right tag': (1094, 309), 'Top right tag': (1094, 166), 'Bottom left tag': (913, 309), 'Top tag': (1003, 166), 'Right tag': (1094, 237), 'Left tag': (913, 237), 'Bottom tag': (1003, 309)}",10
137,HybCD1-B4-D5-LocoPre-TC-US,Rectangle,Hiding-corner-4,Yellow,"(0, 255, 255)",5,122,1030,269,1168,147,138,"{'Center tag': (195, 1099), 'Top left tag': (122, 1030), 'Bottom right tag': (269, 1168), 'Top right tag': (269, 1030), 'Bottom left tag': (122, 1168), 'Top tag': (195, 1030), 'Right tag': (269, 1099), 'Left tag': (122, 1099), 'Bottom tag': (195, 1168)}",10
138,HybCD1-B4-D5-LocoPre-TC-US,Rectangle,Hiding-corner-1,Yellow,"(0, 255, 255)",5,109,175,256,313,147,138,"{'Center tag': (182, 244), 'Top left tag': (109, 175), 'Bottom right tag': (256, 313), 'Top right tag': (256, 175), 'Bottom left tag': (109, 313), 'Top tag': (182, 175), 'Right tag': (256, 244), 'Left tag': (109, 244), 'Bottom tag': (182, 313)}",10
139,HybCD1-B4-D5-LocoPre-TC-US,Rectangle,Hiding-corner-2,Yellow,"(0, 255, 255)",5,1775,152,1922,290,147,138,"{'Center tag': (1848, 221), 'Top left tag': (1775, 152), 'Bottom right tag': (1922, 290), 'Top right tag': (1922, 152), 'Bottom left tag': (1775, 290), 'Top tag': (1848, 152), 'Right tag': (1922, 221), 'Left tag': (1775, 221), 'Bottom tag': (1848, 290)}",10
140,HybCD1-B4-D5-LocoPre-TC-US,Rectangle,Resource zone,Green,"(0, 128, 0)",5,786,184,1218,489,432,305,"{'Center tag': (1002, 336), 'Top left tag': (786, 184), 'Bottom right tag': (1218, 489), 'Top right tag': (1218, 184), 'Bottom left tag': (786, 489), 'Top tag': (1002, 184), 'Right tag': (1218, 336), 'Left tag': (786, 336), 'Bottom tag': (1002, 489)}",10
141,HybCD1-B4-D5-LocoPre-TC-US,Rectangle,Hiding-corner-3,Yellow,"(0, 255, 255)",5,1766,999,1913,1137,147,138,"{'Center tag': (1839, 1068), 'Top left tag': (1766, 999), 'Bottom right tag': (1913, 1137), 'Top right tag': (1913, 999), 'Bottom left tag': (1766, 1137), 'Top tag': (1839, 999), 'Right tag': (1913, 1068), 'Left tag': (1766, 1068), 'Bottom tag': (1839, 1137)}",10
142,HybCD1-B4-D5-LocoPre-TC-US,Rectangle,Middle wall,Chocolate,"(30, 105, 210)",5,977,490,1020,1183,43,693,"{'Center tag': (998, 836), 'Top left tag': (977, 490), 'Bottom right tag': (1020, 1183), 'Top right tag': (1020, 490), 'Bottom left tag': (977, 1183), 'Top tag': (998, 490), 'Right tag': (1020, 836), 'Left tag': (977, 836), 'Bottom tag': (998, 1183)}",10
143,HybCD1-B4-D5-LocoPre-TC-US,Rectangle,Gate-Non-Fighting,Coral,"(80, 127, 255)",5,1011,1067,1137,1178,126,111,"{'Center tag': (1074, 1122), 'Top left tag': (1011, 1067), 'Bottom right tag': (1137, 1178), 'Top right tag': (1137, 1067), 'Bottom left tag': (1011, 1178), 'Top tag': (1074, 1067), 'Right tag': (1137, 1122), 'Left tag': (1011, 1122), 'Bottom tag': (1074, 1178)}",10
